1111111111111111111111
1000C00000000E01010001
10C00C0000000000000001
100C000000010000000001
100000010C000000000001
100B000100000000000001
1010000C10000000P00001
1111111111111111111111