1111111111111111111111
1000000000000E01010001
1000000000000000000001
1000000000010000000001
1000000100000000000001
1000000100000000000001
1010000010000000P00001
1111111111111111111111